0000000000000000000000000
0000000000000000000000000
0000000000000000000000000
0000000000000000000000000
0009030000000000000000000
0000000000000000000000000
0000000000000000000000000
0000000000000000000000000
0000000000000000000000040
1222222222300122222222223
0000000000000000000000000
0000000000000000000000000
0000000000000000000000000
0000000000000000000000000
0000000000000000000000000