0000000000000000000000000
9000000000000000000000000
1230000000000000000000000
0000000060000000000000000
0000001223000000000000000
0000000000000000000000000
0000000000000000000000000
0000000000000000000000000
0000600000000000600000000
1222222222300012223000000
0000000000000000000000000
0000000000000000000000000
0000000000000000000000004
0000000006000000012300000
2230012222222222222300012