9000000000006000000000004
1222300000122223000000012
0000000013000000000000120
0000000000000000000000000
0000000000000000000123000
0000000001223000000000000
0000000000000000000000012
0000000000000000000000000
6000000000000000600001222
1222230122300012223000000
0000000000000000000000000
0000000000000000000000000
0000000000000000000122300
0000000000060000000000000
2230012222222222222300000