0000000000000000000000000
0000000000000000000000000
0000000000000000000000000
0000000000000000000000000
0000000000000000000000000
0000000000000000000000000
0000000000000000000000000
0000000000000000000000000
9000000000000000600000000
1222222222300012223000000
0000000000000000000000000
0000000000000000000000000
4000000000000000000000004
2300000000000000012300000
2230012222222222222300012